********************************
*                              *
*                              *
*                              *
*                              *
*                              *
*                              *
*                              *
*                              *
*                **            *
*                 **           *
*                  **          *
*                *  * *        *
*                **   *        *
*                *  * *        *
*                  **          *
*                 **           *
*                **            *
*                              *
*                              *
*                              *
*                              *
*                              *
*                              *
*                              *
*                              *
*                              *
*                              *
*                              *
*                              *
*                              *
********************************
